Andrias	GENUS
Pseudobranchus	GENUS
Gyrinophilus	GENUS
Stoichactis	GENUS
Centropyge	GENUS
Protohynobius	GENUS
Cryptocentrus	GENUS
Moraxella	GENUS
Proteus	GENUS
Taricha	GENUS
Corynebacterium	GENUS
Plexaura	GENUS
Notophthalmus	GENUS
Abudefduf	GENUS
Oedipina	GENUS
Bordetella	GENUS
Amblygobius	GENUS
Ambystoma	GENUS
Lysinibacillus	GENUS
Rickettsia	GENUS
Enterococcus	GENUS
Amphiprion	GENUS
Mycobacterium	GENUS
Speleomantes	GENUS
Pterosynchiropus	GENUS
Turbo	GENUS
Chelatococcus	GENUS
Aneides	GENUS
Cynops	GENUS
Xanthomonas	GENUS
Actinodiscus	GENUS
Hydromantes	GENUS
Ptereleotris	GENUS
Echinotriton	GENUS
Borrelia	GENUS
Ixalotriton	GENUS
Neisseria	GENUS
Amphiuma	GENUS
Urspelerpes	GENUS
Cyprinodon	GENUS
Oenopota	GENUS
Lysmata	GENUS
Lineatriton	GENUS
Dascyllus	GENUS
Gobiodon	GENUS
Hippocampus	GENUS
Clostridium	GENUS
Pterapogon	GENUS
Batrachoseps	GENUS
Bradytriton	GENUS
Oxymonacanthus	GENUS
Chiropterotriton	GENUS
Tridacna	GENUS
Heteractis	GENUS
Glyphidodontops	GENUS
Eubacterium	GENUS
Enterobacter	GENUS
Parvimolge	GENUS
Lithopoma	GENUS
Ensatina	GENUS
Salamandrella	GENUS
Batrachuperus	GENUS
Liopropoma	GENUS
Favia	GENUS
Strongylocentrotus	GENUS
Montipora	GENUS
Stomphia	GENUS
Coryphaena	GENUS
Escherichia	GENUS
Dendrotriton	GENUS
Salamandrina	GENUS
Dicamptodon	GENUS
Hemiscyllium	GENUS
Paradactylodon	GENUS
Haideotriton	GENUS
Pleurodeles	GENUS
Serratia	GENUS
Palaemonetes	GENUS
Neurergus	GENUS
Pseudanthias	GENUS
Genicanthus	GENUS
Ranodon	GENUS
Cryptobranchus	GENUS
Karsenia	GENUS
Necturus	GENUS
Notoacmaea	GENUS
Opistognathus	GENUS
Vibrio	GENUS
Klebsiella	GENUS
Salmonella	GENUS
Helicobacter	GENUS
Brucella	GENUS
Actinomyces	GENUS
Ptilosarcus	GENUS
Flavobacterium	GENUS
Crassostrea	GENUS
Pseudotriton	GENUS
Haemulon	GENUS
Pachyhynobius	GENUS
Bacillus	GENUS
Actinia	GENUS
Salarias	GENUS
Homalopoma	GENUS
Phaeognathus	GENUS
Salamandra	GENUS
Chaetodipterus	GENUS
Mercenaria	GENUS
Nautilus	GENUS
Thorius	GENUS
Siren	GENUS
Mesotriton	GENUS
Pseudoeurycea	GENUS
Cryptotriton	GENUS
Premnas	GENUS
Octopus	GENUS
Hymenocera	GENUS
Treponema	GENUS
Lyciasalamandra	GENUS
Equetus	GENUS
Bolitoglossa	GENUS
Ureaplasma	GENUS
Nototriton	GENUS
Tylototriton	GENUS
Chrysiptera	GENUS
Synchiropus	GENUS
Lissotriton	GENUS
Shigella	GENUS
Muricea	GENUS
Nemateleotris	GENUS
Ommatotriton	GENUS
Euproctus	GENUS
Yersinia	GENUS
Legionella	GENUS
Desmognathus	GENUS
Onychodactylus	GENUS
Pseudomonas	GENUS
Liua	GENUS
Mertensiella	GENUS
Staphylococcus	GENUS
Gobiosoma	GENUS
Apogon	GENUS
Pempheris	GENUS
Stereochilus	GENUS
Hemidactylium	GENUS
Rhyacotriton	GENUS
Francisella	GENUS
Gramma	GENUS
Rhinecanthus	GENUS
Acinetobacter	GENUS
Chioglossa	GENUS
Paramesotriton	GENUS
Xenia	GENUS
Campylobacter	GENUS
Stichodactyla	GENUS
Caulastrea	GENUS
Plethodon	GENUS
Meiacanthus	GENUS
Stegostoma	GENUS
Calotriton	GENUS
Diadema	GENUS
Triturus	GENUS
Histrio	GENUS
Pseudocheilinus	GENUS
Hynobius	GENUS
Streptococcus	GENUS
Pachytriton	GENUS
Pseudochromis	GENUS
Providencia	GENUS
Nyctanolis	GENUS
Pomacentrus	GENUS
Valenciennea	GENUS
Eurycea	GENUS
Pseudohynobius	GENUS
Leptospira	GENUS
Spirillum	GENUS
Hypsoblennius	GENUS
resplendens	SPECIES
beyeri	SPECIES
caddoensis	SPECIES
heiroreias	SPECIES
fazilae	SPECIES
punctatus	SPECIES
pertussis	SPECIES
multidentatus	SPECIES
magnipes	SPECIES
shanjing	SPECIES
mercenaria	SPECIES
taylori	SPECIES
gracilis	SPECIES
complex	SPECIES
aculeatus	SPECIES
meliana	SPECIES
strinatii	SPECIES
flavomaculatus	SPECIES
hidamontanus	SPECIES
multiplicata	SPECIES
phalarosoma	SPECIES
tuberculosis	SPECIES
shangchengensis	SPECIES
interrogans	SPECIES
haddoni	SPECIES
puxiongensis	SPECIES
vietnamensis	SPECIES
pennatulus	SPECIES
minydemus	SPECIES
alleni	SPECIES
sarrabusensis	SPECIES
insperatus	SPECIES
leprosa	SPECIES
imitator	SPECIES
copia	SPECIES
faber	SPECIES
mabeei	SPECIES
lanzai	SPECIES
faecalis	SPECIES
picadoi	SPECIES
robertsi	SPECIES
antillarium	SPECIES
sooyorum	SPECIES
tibicen	SPECIES
arisanensis	SPECIES
sherando	SPECIES
akindynos	SPECIES
mosaueri	SPECIES
chondrostega	SPECIES
cuchumatana	SPECIES
sonnei	SPECIES
flavimembris	SPECIES
welleri	SPECIES
leorae	SPECIES
oaxacensis	SPECIES
hardii	SPECIES
flavipiperatum	SPECIES
atifi	SPECIES
collaris	SPECIES
hongkongensis	SPECIES
shepardi	SPECIES
occidentalis	SPECIES
maxima	SPECIES
adelos	SPECIES
opacum	SPECIES
capitana	SPECIES
walkeri	SPECIES
yatsui	SPECIES
chinensis	SPECIES
hermosa	SPECIES
flavolineatum	SPECIES
lichenatus	SPECIES
idahoensis	SPECIES
altamirani	SPECIES
magnifica	SPECIES
sombra	SPECIES
townsendi	SPECIES
hartwegi	SPECIES
dorsalis	SPECIES
biseriata	SPECIES
exspectata	SPECIES
compressus	SPECIES
flavipunctatus	SPECIES
amplus	SPECIES
melanomolga	SPECIES
puellaris	SPECIES
latezonatus	SPECIES
flaviventris	SPECIES
archospotus	SPECIES
spilogaster	SPECIES
chinhaiensis	SPECIES
subterraneus	SPECIES
fragum	SPECIES
borburata	SPECIES
dofleini	SPECIES
spongai	SPECIES
gurneyi	SPECIES
diminuta	SPECIES
obesa	SPECIES
copei	SPECIES
orchimelas	SPECIES
helveticus	SPECIES
orestes	SPECIES
debelius	SPECIES
strauchii	SPECIES
larselli	SPECIES
striatus	SPECIES
tlahcuiloh	SPECIES
lignicola	SPECIES
rex	SPECIES
quadridigitata	SPECIES
kawia	SPECIES
abei	SPECIES
californiense	SPECIES
lugubris	SPECIES
carri	SPECIES
tsinpaensis	SPECIES
savagei	SPECIES
diaphora	SPECIES
ocoee	SPECIES
stejnegeri	SPECIES
carnifex	SPECIES
cholerae	SPECIES
ferreus	SPECIES
alfaroi	SPECIES
altura	SPECIES
odonnelli	SPECIES
latitans	SPECIES
dobrogicus	SPECIES
naucampatepetl	SPECIES
ainsworthi	SPECIES
hentz	SPECIES
indio	SPECIES
axanthus	SPECIES
kauderni	SPECIES
diphtheriae	SPECIES
aurifrons	SPECIES
fischeri	SPECIES
jeffersonianum	SPECIES
epimela	SPECIES
wurdemanni	SPECIES
ventralis	SPECIES
nebulosus	SPECIES
phalaena	SPECIES
medemi	SPECIES
mexicanum	SPECIES
gadovii	SPECIES
nigromaculata	SPECIES
mycoides	SPECIES
ensicauda	SPECIES
clarkii	SPECIES
carablanca	SPECIES
stenopodia	SPECIES
vagrans	SPECIES
apalachicolae	SPECIES
albimaculatis	SPECIES
richardi	SPECIES
serratus	SPECIES
chenggongensis	SPECIES
aurantia	SPECIES
dilectus	SPECIES
enteritidis	SPECIES
altamazonica	SPECIES
orphicus	SPECIES
ruficauda	SPECIES
maculosus	SPECIES
mulleri	SPECIES
mexicana	SPECIES
peruviana	SPECIES
subtilis	SPECIES
scandens	SPECIES
sequoyah	SPECIES
jacksoni	SPECIES
neomexicanus	SPECIES
ensatus	SPECIES
californica	SPECIES
variegatus	SPECIES
argi	SPECIES
vericosa	SPECIES
tokyoensis	SPECIES
perstriatus	SPECIES
salvinii	SPECIES
marcescens	SPECIES
monzoni	SPECIES
abortus	SPECIES
lucifuga	SPECIES
alactolyticum	SPECIES
uniformis	SPECIES
abscondens	SPECIES
macrinii	SPECIES
lividensis	SPECIES
ruber	SPECIES
poireti	SPECIES
zosterae	SPECIES
xolocalcae	SPECIES
equatoriana	SPECIES
alabamensis	SPECIES
amjiensis	SPECIES
tatamae	SPECIES
melanopus	SPECIES
mirabilis	SPECIES
megarhinus	SPECIES
synoria	SPECIES
priscus	SPECIES
arboreus	SPECIES
anthracina	SPECIES
guabangshanensis	SPECIES
minutula	SPECIES
lacertina	SPECIES
goebeli	SPECIES
digitalis	SPECIES
cyanea	SPECIES
attenuatus	SPECIES
marginatus	SPECIES
loriculus	SPECIES
nasalis	SPECIES
welteri	SPECIES
droebachiensis	SPECIES
lacunata	SPECIES
kentucki	SPECIES
pulmonaris	SPECIES
brevipes	SPECIES
trimaculatus	SPECIES
dubitus	SPECIES
naufragia	SPECIES
canis	SPECIES
robusta	SPECIES
fuca	SPECIES
longliensis	SPECIES
alvaradoi	SPECIES
supramontis	SPECIES
rufescens	SPECIES
longdongensis	SPECIES
fasciatus	SPECIES
tridactylum	SPECIES
stuarti	SPECIES
gavilanensis	SPECIES
gorganensis	SPECIES
aquatica	SPECIES
lermaense	SPECIES
brunnata	SPECIES
loreto	SPECIES
tetani	SPECIES
quadramaculatus	SPECIES
gulolineatus	SPECIES
sp.	SPECIES
kisatchie	SPECIES
species	SPECIES
pylori	SPECIES
oceanops	SPECIES
mississippi	SPECIES
muralis	SPECIES
yucatana	SPECIES
histrix	SPECIES
asperrimus	SPECIES
lincolni	SPECIES
minor	SPECIES
sonani	SPECIES
niger	SPECIES
electromorphus	SPECIES
celaque	SPECIES
histrio	SPECIES
hypacra	SPECIES
cuna	SPECIES
ambrosii	SPECIES
shenandoah	SPECIES
atra	SPECIES
pompilius	SPECIES
planiceps	SPECIES
anthracis	SPECIES
recurrentis	SPECIES
alvarezdeltoroi	SPECIES
shermani	SPECIES
intermedia	SPECIES
arnoldii	SPECIES
folkertsi	SPECIES
wenxianensis	SPECIES
bishopi	SPECIES
rosaceum	SPECIES
guaramacalensis	SPECIES
catarrhalis	SPECIES
longicauda	SPECIES
bellii	SPECIES
tsuensis	SPECIES
chica	SPECIES
nettingi	SPECIES
vehiculum	SPECIES
adspersa	SPECIES
lunaris	SPECIES
tica	SPECIES
insularis	SPECIES
flexneri	SPECIES
oresbia	SPECIES
hainanensis	SPECIES
velasci	SPECIES
boneti	SPECIES
tapanti	SPECIES
dysenteriae	SPECIES
bynoesis	SPECIES
albagula	SPECIES
junaluska	SPECIES
altamontana	SPECIES
gregarius	SPECIES
brucei	SPECIES
virginia	SPECIES
imperialis	SPECIES
vulgaris	SPECIES
gomezi	SPECIES
vittatus	SPECIES
dunni	SPECIES
melanospilos	SPECIES
pugio	SPECIES
boscai	SPECIES
lineolus	SPECIES
gabrieli	SPECIES
umbrosus	SPECIES
pterophila	SPECIES
dumerilii	SPECIES
longissima	SPECIES
cinereus	SPECIES
montandoni	SPECIES
aterrimus	SPECIES
meningitidis	SPECIES
compacta	SPECIES
grammistes	SPECIES
zebra	SPECIES
karlschmidti	SPECIES
papaloae	SPECIES
tlilicxitl	SPECIES
cinctus	SPECIES
nigriventris	SPECIES
kiamichi	SPECIES
meningosepticum	SPECIES
wrightorum	SPECIES
turkestanicus	SPECIES
ophryticus	SPECIES
kuankuoshuiensis	SPECIES
talpoideum	SPECIES
ocellaris	SPECIES
praecellens	SPECIES
rathbuni	SPECIES
reidi	SPECIES
rabbi	SPECIES
munificus	SPECIES
splendidus	SPECIES
pinchonii	SPECIES
quelpaertensis	SPECIES
stebbinsi	SPECIES
flavissimus	SPECIES
quetzalanensis	SPECIES
parvus	SPECIES
caudopunctatus	SPECIES
tridentifera	SPECIES
hoffmani	SPECIES
metcalfi	SPECIES
chattahoochee	SPECIES
wakei	SPECIES
poelzi	SPECIES
morio	SPECIES
gephyra	SPECIES
torosa	SPECIES
sanctibarbarus	SPECIES
bombypellum	SPECIES
briareus	SPECIES
verrucosus	SPECIES
veracrucis	SPECIES
indutum	SPECIES
angusticlavius	SPECIES
calcoaceticus	SPECIES
retardatus	SPECIES
variolatus	SPECIES
franklini	SPECIES
limnospectator	SPECIES
biaculeatus	SPECIES
formosanus	SPECIES
melacara	SPECIES
okinawae	SPECIES
scutatum	SPECIES
carolinensis	SPECIES
vandykei	SPECIES
pestis	SPECIES
nigrescens	SPECIES
asper	SPECIES
tenebrosus	SPECIES
katoi	SPECIES
tigrinum	SPECIES
rivulare	SPECIES
riletti	SPECIES
elongata	SPECIES
genei	SPECIES
shihi	SPECIES
chamberlaini	SPECIES
spelaea	SPECIES
ramosi	SPECIES
striatula	SPECIES
minus	SPECIES
nicefori	SPECIES
wallacei	SPECIES
yiwuensis	SPECIES
takedai	SPECIES
wilderae	SPECIES
sibiricus	SPECIES
cylindraceus	SPECIES
abditis	SPECIES
orculus	SPECIES
ignea	SPECIES
typhimurium	SPECIES
guanxiensis	SPECIES
fuzhongensis	SPECIES
terdigitata	SPECIES
barbouri	SPECIES
taliangensis	SPECIES
cuchumatanus	SPECIES
daeguensis	SPECIES
sima	SPECIES
macedonicus	SPECIES
waltl	SPECIES
aureus	SPECIES
abdominalis	SPECIES
okiensis	SPECIES
mixcoatl	SPECIES
grobmani	SPECIES
brimleyorum	SPECIES
terrestris	SPECIES
cloacae	SPECIES
palleucus	SPECIES
stormi	SPECIES
platycephalus	SPECIES
cerroensis	SPECIES
palmata	SPECIES
monticola	SPECIES
squamipinnus	SPECIES
laterale	SPECIES
brodiei	SPECIES
shastae	SPECIES
wrighti	SPECIES
hexataenia	SPECIES
pesrubra	SPECIES
porrasorum	SPECIES
pneumoniae	SPECIES
fuscus	SPECIES
montanus	SPECIES
tularensis	SPECIES
sosorum	SPECIES
sphaericus	SPECIES
rubre	SPECIES
elongatus	SPECIES
saltator	SPECIES
algira	SPECIES
nana	SPECIES
naevius	SPECIES
gracile	SPECIES
urealyticum	SPECIES
cascadae	SPECIES
dimidiatus	SPECIES
orientalis	SPECIES
juarezi	SPECIES
pacificus	SPECIES
stuartii	SPECIES
pyogenes	SPECIES
kezeri	SPECIES
jejuni	SPECIES
papenfussi	SPECIES
chisholmensis	SPECIES
smithi	SPECIES
fridmani	SPECIES
infraimmaculata	SPECIES
savannah	SPECIES
schomburgkii	SPECIES
ahuitzotl	SPECIES
infernalis	SPECIES
fourchensis	SPECIES
andersoni	SPECIES
obscura	SPECIES
crocatus	SPECIES
guanacastae	SPECIES
israelii	SPECIES
maritima	SPECIES
boydii	SPECIES
amblycephalum	SPECIES
antalyana	SPECIES
websteri	SPECIES
ouachitae	SPECIES
coli	SPECIES
cirrigera	SPECIES
burgdorferi	SPECIES
petraeus	SPECIES
santeetlah	SPECIES
cyaneus	SPECIES
macrodactylum	SPECIES
granulosa	SPECIES
guttolineata	SPECIES
varium	SPECIES
frenatus	SPECIES
lignicolor	SPECIES
mystax	SPECIES
mossambicus	SPECIES
kweichowensis	SPECIES
alcalifaciens	SPECIES
wolterstorffi	SPECIES
relictus	SPECIES
pyrrhogaster	SPECIES
karelinii	SPECIES
microspilotus	SPECIES
cephalica	SPECIES
epidermidis	SPECIES
crispa	SPECIES
tibetanus	SPECIES
rathbunae	SPECIES
cheoah	SPECIES
mixteca	SPECIES
davidianus	SPECIES
aureolus	SPECIES
sebae	SPECIES
luciae	SPECIES
perspicillata	SPECIES
boreas	SPECIES
brunus	SPECIES
subpalmata	SPECIES
pernix	SPECIES
zapoteca	SPECIES
helverseni	SPECIES
boulengeri	SPECIES
tectum	SPECIES
citrinus	SPECIES
werleri	SPECIES
hiemalis	SPECIES
porphyriticus	SPECIES
chiropterus	SPECIES
pacificensis	SPECIES
ordinarium	SPECIES
shuichengensis	SPECIES
yangi	SPECIES
bimaculatus	SPECIES
annulatum	SPECIES
squamosa	SPECIES
cingulatum	SPECIES
meridionalis	SPECIES
asupak	SPECIES
picta	SPECIES
cyanurus	SPECIES
alpestris	SPECIES
omiltemi	SPECIES
virginica	SPECIES
ochrophaeus	SPECIES
pneumophilia	SPECIES
suis	SPECIES
gonorrhoeae	SPECIES
equina	SPECIES
erectus	SPECIES
platydactyla	SPECIES
orchileucos	SPECIES
enlongata	SPECIES
minutissimus	SPECIES
prowazekii	SPECIES
teotepec	SPECIES
colonnea	SPECIES
persicus	SPECIES
didemon	SPECIES
conanti	SPECIES
gigantea	SPECIES
aurora	SPECIES
salamandra	SPECIES
kimurae	SPECIES
olympicus	SPECIES
laoensis	SPECIES
hippurus	SPECIES
corsica	SPECIES
castanea	SPECIES
caucasica	SPECIES
texanum	SPECIES
fortunensis	SPECIES
cyclocauda	SPECIES
auriculatus	SPECIES
cochranae	SPECIES
marmoratus	SPECIES
amboinensis	SPECIES
billae	SPECIES
means	SPECIES
neotenes	SPECIES
viridescens	SPECIES
pholeter	SPECIES
pseudouniformis	SPECIES
firscheini	SPECIES
mavortium	SPECIES
leechii	SPECIES
silvensis	SPECIES
robinsoni	SPECIES
cracens	SPECIES
bislineata	SPECIES
incognitus	SPECIES
silus	SPECIES
parvipes	SPECIES
helianthus	SPECIES
traceyi	SPECIES
maculatum	SPECIES
jordani	SPECIES
flavus	SPECIES
anguinus	SPECIES
schmidti	SPECIES
margaritophorus	SPECIES
glutinosus	SPECIES
schrenckii	SPECIES
grandis	SPECIES
pallidum	SPECIES
bicolor	SPECIES
percula	SPECIES
aruanus	SPECIES
meridianus	SPECIES
bromeliacia	SPECIES
paucidentata	SPECIES
bramei	SPECIES
nigripes	SPECIES
melitensis	SPECIES
major	SPECIES
waterlooensis	SPECIES
luschani	SPECIES
veraepacis	SPECIES
italicus	SPECIES
ocmulgee	SPECIES
lavae	SPECIES
silverstonei	SPECIES
chlorobryonis	SPECIES
tomasi	SPECIES
mustersi	SPECIES
paraensis	SPECIES
rettgeri	SPECIES
campi	SPECIES
engelhardti	SPECIES
lynchi	SPECIES
rivularis	SPECIES
simatus	SPECIES
unguidentis	SPECIES
mombachoensis	SPECIES
helmrichi	SPECIES
lewisi	SPECIES
curvata	SPECIES
narisovalis	SPECIES
cristatus	SPECIES
hirosei	SPECIES
pygmaeus	SPECIES
tenchalli	SPECIES
diabolicus	SPECIES
deloustali	SPECIES
galeanae	SPECIES
pandi	SPECIES
oscellatum	SPECIES
maoershanensis	SPECIES
richmondi	SPECIES
glacialis	SPECIES
ephippium	SPECIES
teyahalee	SPECIES
narismagnus	SPECIES
vallecula	SPECIES
koreana	SPECIES
aeruginosa	SPECIES
yonahlossee	SPECIES
digitigrada	SPECIES
schizodactyla	SPECIES
hubrichti	SPECIES
alberchi	SPECIES
rostrata	SPECIES
amuzga	SPECIES
marmorea	SPECIES
eschscholtzii	SPECIES
saslaya	SPECIES
saprophyticus	SPECIES
tynerensis	SPECIES
macdougalli	SPECIES
kaiseri	SPECIES
choleraesuis	SPECIES
keyserlingii	SPECIES
labiatus	SPECIES
zhijinensis	SPECIES
caeruleus	SPECIES
troglodytes	SPECIES
gamezi	SPECIES
sierrae	SPECIES
tonkawae	SPECIES
aeneus	SPECIES
lozanoi	SPECIES
lusitanica	SPECIES
robustus	SPECIES
wehrlei	SPECIES
longirostris	SPECIES
alleghaniensis	SPECIES
granulosum	SPECIES
anitae	SPECIES
japonicus	SPECIES
regius	SPECIES
maltophilia	SPECIES
decora	SPECIES
yenyuanensis	SPECIES
